name	url	reviews
American Folk Art Museum	American Folk Art Museum	/biz/american-folk-art-museum-new-york
Art in General	Art In General	/biz/art-in-general-new-york
Asia Society	The Asia Society	/biz/the-asia-society-new-york
Asian American Arts Centre	Asian American Arts Centre	/biz/asian-american-arts-centre-new-york
Brooklyn Museum	Brooklyn Museum	/biz/brooklyn-museum-brooklyn-2
Bronx Museum of the Arts	Bronx Museum of the Arts	/biz/bronx-museum-of-the-arts-bronx
Chelsea Art Museum	The Chelsea Art Museum	/biz/the-chelsea-art-museum-new-york
China Institute in America	China Institute In America	/biz/china-institute-in-america-new-york
Dahesh Museum of Art	Dahesh Museum Inc	/biz/dahesh-museum-inc-new-york
Dia Art Foundation
The Drawing Center	The Drawing Center	/biz/the-drawing-center-new-york
Fisher Landau Center	Fisher Landau Center For Art	/biz/fisher-landau-center-for-art-long-island-city
Forbes Galleries	Forbes Magazine Galleries	/biz/forbes-magazine-galleries-new-york
Frick Collection	Frick Collection	/biz/frick-collection-new-york
International Center of Photography	International Center of Photography	/biz/international-center-of-photography-new-york
International Print Center New York	International Print Center New York	/biz/international-print-center-new-york-new-york
Jacques Marchais Museum of Tibetan Art	Jacques Marchais Museum of Tibetan Art	/biz/jacques-marchais-museum-of-tibetan-art-staten-island
Japan Society	Japan Society	/biz/japan-society-new-york-2
Korea Society	The Korea Society	/biz/the-korea-society-new-york
Metropolitan Museum of Art	Metropolitan Museum Of Art	/biz/metropolitan-museum-of-art-new-york
The Cloisters	The Cloisters	/biz/the-cloisters-new-york-2
Municipal Art Society	Municipal Art Society the Information Exchange	/biz/municipal-art-society-the-information-exchange-new-york
Museum for African Art	Museum For African Art	/biz/museum-for-african-art-long-island-city
Museum of Arts & Design	Museum of Arts and Design	/biz/museum-of-arts-and-design-new-york-2
Museum of Biblical Art	Museum of Biblical Art	/biz/museum-of-biblical-art-new-york
Museum of Comic and Cartoon Art	Museum Of Comic & Cartoon Art	/biz/museum-of-comic-and-cartoon-art-new-york-2
Museum of Modern Art	Museum of Modern Art	/biz/museum-of-modern-art-new-york
Museum of the Moving Image	Museum Of The Moving Image	/biz/museum-of-the-moving-image-astoria
National Museum of Catholic Art and History	National Museum of Catholic Art & History - CLOSED	/biz/national-museum-of-catholic-art-and-history-new-york
Neue Galerie	Neue Galerie New York	/biz/neue-galerie-new-york-new-york
New Museum of Contemporary Art	New Museum of Contemporary Art	/biz/new-museum-of-contemporary-art-new-york-2
New York Tattoo Museum
Nicholas Roerich Museum	Nicholas Roerich Museum	/biz/nicholas-roerich-museum-new-york
The Noguchi Museum	The Noguchi Museum	/biz/the-noguchi-museum-long-island-city
P.S. 1 Contemporary Art Center	Museum of Modern Art	/biz/moma-ps1-long-island-city
Queens Museum of Art	Queens Museum of Art	/biz/queens-museum-of-art-queens
Rubin Museum of Art	Rubin Museum Of Art	/biz/rubin-museum-of-art-new-york
SculptureCenter	Sculpture Center	/biz/sculpture-center-long-island-city-2
Socrates Sculpture Park	Socrates Sculpture Park	/biz/socrates-sculpture-park-astoria
Solomon R. Guggenheim Museum	Guggenheim Museum	/biz/guggenheim-museum-new-york
Studio Museum in Harlem	Atrium Cafe at The Studio Museum in Harlem	/biz/studio-museum-harlem-new-york
Williamsburg Art & Historical Center	Williamsburg Art & Historical Center	/biz/williamsburg-art-and-historical-center-brooklyn
White Columns	White Columns	/biz/white-columns-new-york
Whitney Museum of American Art	Whitney Museum of American Art	/biz/whitney-museum-of-american-art-new-york
American Museum of Natural History	American Museum of Natural History	/biz/american-museum-of-natural-history-new-york
Brooklyn Historical Society	Brooklyn Historical Society	/biz/brooklyn-historical-society-brooklyn
Brooklyn Museum	Brooklyn Museum	/biz/brooklyn-museum-brooklyn-2
Casa Belvedere	Casa Belvedere Incorporated	/biz/casa-belvedere-incorporated-staten-island
China Institute in America	China Institute In America	/biz/china-institute-in-america-new-york
Conference House	Conference House Association Inc	/biz/conference-house-association-inc-staten-island
Center for Jewish History	The Center For Jewish History	/biz/the-center-for-jewish-history-new-york
Coney Island USA	Coney Island Circus Sideshow	/biz/coney-island-museum-brooklyn
Discovery Times Square Exposition	Discovery Times Square Exposition	/biz/discovery-times-square-exposition-new-york
Dyckman House Museum	Dyckman Farmhouse Museum	/biz/dyckman-farmhouse-museum-new-york
Fraunces Tavern Museum	Fraunces Tavern Museum	/biz/fraunces-tavern-museum-new-york
Greater Astoria Historical Society	Greater Astoria Historical Society	/biz/greater-astoria-historical-society-long-island-city
Harbor Defense Museum
Hispanic Society of America	Hispanic Society of America	/biz/hispanic-society-of-america-new-york
Historic Richmond Town	Historic Richmond Town	/biz/historic-richmond-town-staten-island
Intrepid Sea-Air-Space Museum	Intrepid Sea, Air & Space Museum	/biz/intrepid-sea-air-and-space-museum-new-york
Jewish Museum (New York)	The Jewish Museum	/biz/the-jewish-museum-new-york
Louis Armstrong House	Louis Armstrong House Museum	/biz/louis-armstrong-house-museum-corona
Merchant's House Museum	Merchant's House Museum	/biz/merchants-house-museum-new-york
El Museo del Barrio	El Museo Del Barrio	/biz/el-museo-del-barrio-new-york
Ellis Island Immigration Museum	Ellis Island Immigration Museum	/biz/ellis-island-immigration-museum-new-york
Madame Tussauds Wax Museum	Madame Tussauds New York	/biz/madame-tussauds-new-york-new-york
Museum of American Finance	The Museum of American Finance	/biz/the-museum-of-american-finance-new-york
Museum of the City of New York	Museum of the City of New York	/biz/museum-of-the-city-of-new-york-new-york
Museum of the Moving Image	Museum Of The Moving Image	/biz/museum-of-the-moving-image-astoria
Museum of Chinese in America	Museum of Chinese in America	/biz/museum-of-chinese-in-america-new-york
Museum at Eldridge Street	The Museum at Eldridge Street	/biz/the-museum-at-eldridge-street-new-york
Museum of Jewish Heritage	Museum of Jewish Heritage	/biz/museum-of-jewish-heritage-new-york-2
Museum of Sex	Museum of Sex	/biz/museum-of-sex-new-york
Museum of Television and Radio	Museum Of Television & Radio	/biz/museum-of-television-and-radio-new-york-2
National Museum of the American Indian	National Museum of the American Indian	/biz/national-museum-of-the-american-indian-new-york
National Museum of Lesbian, Gay, Bisexual & Transgender History	The Lesbian, Gay, Bisexual & Transgender Community Center	/biz/the-lesbian-gay-bisexual-and-transgender-community-center-new-york
Sports Museum of America	Metropolitan Museum Of Art	/biz/national-sports-museum-new-york
New York City Fire Museum	NYC Fire Museum	/biz/nyc-fire-museum-new-york
New York City Police Museum	New York City Police Museum	/biz/new-york-city-police-museum-new-york
New-York Historical Society	New York Historical Society	/biz/new-york-historical-society-new-york-2
New York Transit Museum	New York Transit Museum	/biz/new-york-transit-museum-brooklyn
The Paley Center for Media	Paley Center for Media	/biz/paley-center-for-media-new-york
Queens County Farm Museum	Queens County Farm Museum	/biz/queens-county-farm-museum-floral-park
Ripley's Believe It or Not!	Ripley's Believe It or Not	/biz/ripleys-believe-it-or-not-new-york-2
Skyscraper Museum	Skyscraper Museum	/biz/skyscraper-museum-new-york
Sony Wonder Technology Lab	Sony Wonder Technology Lab	/biz/sony-wonder-technology-lab-new-york
South Street Seaport Museum	South Street Seaport Museum	/biz/south-street-seaport-museum-new-york-2
Staten Island Institute of Arts & Sciences
Yeshiva University Museum	Yeshiva University Museum	/biz/yeshiva-university-museum-manhattan
Center for Architecture	Center for Architecture	/biz/center-for-architecture-new-york
Cooper-Hewitt, National Design Museum	Cooper-Hewitt Museum	/biz/cooper-hewitt-museum-new-york
Fashion Institute of Technology	Fashion Institute of Technology	/biz/fashion-institute-of-technology-new-york-2
National Academy of Design	National Academy of Design	/biz/national-academy-of-design-new-york
Parsons The New School for Design	Parsons The New School For Design	/biz/parsons-the-new-school-for-design-new-york-4
American Museum of Natural History	American Museum of Natural History	/biz/american-museum-of-natural-history-new-york
Hayden Planetarium	Hayden Planetarium	/biz/hayden-planetarium-new-york-2
Bronx Zoo	Bronx Zoo	/biz/bronx-zoo-bronx
Brooklyn Botanic Garden	Brooklyn Botanic Garden	/biz/brooklyn-botanic-garden-brooklyn-2
Central Park Zoo	Central Park Zoo	/biz/central-park-zoo-new-york-6
Jamaica Bay Wildlife Refuge	Jamaica Bay Wildlife Refuge	/biz/jamaica-bay-wildlife-refuge-queens
New York Aquarium	The New York Aquarium	/biz/the-new-york-aquarium-brooklyn
New York Botanical Garden	New York Botanical Garden	/biz/new-york-botanical-garden-bronx
New York Hall of Science	New York Hall of Science	/biz/new-york-hall-of-science-corona
Prospect Park Zoo	Prospect Park Zoo	/biz/prospect-park-zoo-brooklyn
Queens Botanical Garden	Queens Botanical Garden	/biz/queens-botanical-garden-flushing
Queens Zoo	Queens Zoo	/biz/queens-zoo-corona
Staten Island Zoo	Staten Island Zoo	/biz/staten-island-zoo-staten-island
Staten Island Botanical Garden	Staten Island Botanical Garden Inc	/biz/staten-island-botanical-garden-inc-staten-island
The New York Chinese Scholar's Garden	The New York Chinese Scholar's Garden	/biz/the-new-york-chinese-scholars-garden-staten-island
Wave Hill	Wave Hill	/biz/wave-hill-bronx-2
Brooklyn Children's Museum	Brooklyn Children's Museum	/biz/brooklyn-childrens-museum-brooklyn
Children's Museum of the Arts	Children's Museum of the Arts	/biz/childrens-museum-of-the-arts-new-york
Children's Museum of Manhattan	Children's Museum of Manhattan	/biz/childrens-museum-of-manhattan-new-york
Jewish Children's Museum	The Jewish Children's Museum - CLOSED	/biz/the-jewish-childrens-museum-brooklyn
Staten Island Children's Museum	Staten Island Childrens Museum	/biz/staten-island-childrens-museum-staten-island